           10.ox
..o.oo...o.....
o........o.....
.......o.......
..o..o.........
.....o........o
....o.....o....
...o.....o....1
...........o...
.o............o
...o.o.........